[
  {
    "start_position": [0, 4],
    "layout": [
      [0, 0, 0, 0, 0, 0, 0, 0, 0],
      [0, 0, 0, 0, 0, 0, 0, 0, 0],
      [0, 0, 0, 0, 0, 0, 0, 0, 0],
      [1, 1, 1, 1, 1, 1, 1, 1, 1],
      [0, 0, 0, 0, 0, 0, 0, 0, 2],
      [1, 1, 1, 1, 1, 1, 1, 1, 1],
      [0, 0, 0, 0, 0, 0, 0, 0, 0],
      [0, 0, 0, 0, 0, 0, 0, 0, 0],
      [0, 0, 0, 0, 0, 0, 0, 0, 0]
    ]
  },
  {
    "start_position": [0, 4],
    "layout": [
      [0, 0, 0, 0, 0, 0, 0, 0, 0],
      [0, 0, 1, 1, 1, 1, 1, 0, 0],
      [0, 0, 1, 0, 0, 0, 1, 0, 0],
      [1, 1, 1, 0, 1, 0, 1, 1, 1],
      [0, 0, 0, 0, 1, 0, 0, 0, 2],
      [1, 1, 1, 1, 1, 1, 1, 1, 1],
      [0, 0, 0, 0, 0, 0, 0, 0, 0],
      [0, 0, 0, 0, 0, 0, 0, 0, 0],
      [0, 0, 0, 0, 0, 0, 0, 0, 0]
    ]
  },
  {
    "start_position": [0, 4],
    "layout": [
      [0, 0, 0, 0, 0, 0, 0, 0, 0],
      [0, 1, 1, 1, 1, 1, 1, 1, 0],
      [0, 1, 0, 0, 0, 0, 0, 1, 0],
      [1, 1, 0, 1, 1, 1, 0, 1, 1],
      [0, 0, 0, 1, 1, 1, 0, 0, 2],
      [1, 1, 0, 1, 1, 1, 0, 1, 1],
      [0, 1, 0, 0, 0, 0, 0, 1, 0],
      [0, 1, 1, 1, 1, 1, 1, 1, 0],
      [0, 0, 0, 0, 0, 0, 0, 0, 0]
    ]
  },
  {
    "start_position": [1, 1],
    "layout": [
      [1, 1, 1, 1, 1, 1, 1, 1, 1],
      [1, 0, 0, 0, 0, 0, 0, 0, 1],
      [1, 0, 1, 0, 1, 1, 1, 0, 1],
      [1, 0, 1, 0, 0, 0, 1, 0, 1],
      [1, 0, 1, 1, 1, 0, 1, 1, 1],
      [1, 0, 0, 0, 1, 0, 0, 0, 1],
      [1, 1, 1, 0, 1, 1, 1, 0, 1],
      [1, 0, 0, 0, 0, 0, 0, 2, 1],
      [1, 1, 1, 1, 1, 1, 1, 1, 1]
    ]
  },
  {
    "start_position": [1, 1],
    "layout": [
      [1, 1, 1, 1, 1, 1, 1, 1, 1],
      [1, 0, 1, 2, 0, 0, 0, 0, 1],
      [1, 0, 1, 1, 1, 1, 0, 0, 1],
      [1, 0, 0, 0, 0, 1, 0, 0, 1],
      [1, 0, 1, 1, 0, 1, 0, 0, 1],
      [1, 0, 0, 1, 0, 1, 0, 0, 1],
      [1, 1, 0, 1, 0, 0, 0, 0, 1],
      [1, 1, 0, 1, 0, 1, 0, 0, 1],
      [1, 1, 1, 1, 1, 1, 1, 1, 1]
    ]
  },
  {
    "start_position": [4, 2],
    "layout": [
      [1, 1, 1, 1, 1, 1, 1, 1, 1],
      [1, 1, 1, 1, 0, 1, 1, 1, 1],
      [1, 1, 1, 1, 0, 1, 1, 1, 1],
      [1, 1, 1, 1, 0, 1, 1, 1, 1],
      [1, 0, 0, 0, 0, 0, 0, 0, 1],
      [1, 1, 0, 1, 0, 1, 1, 1, 1],
      [1, 1, 2, 0, 0, 1, 1, 1, 1],
      [1, 1, 1, 1, 0, 1, 1, 1, 1],
      [1, 1, 1, 1, 1, 1, 1, 1, 1]
    ]
  },
  {
    "start_position": [7, 1],
    "layout": [
      [1, 1, 1, 1, 1, 1, 1, 1, 1],
      [1, 0, 0, 0, 0, 0, 0, 0, 1],
      [1, 0, 1, 1, 1, 1, 0, 1, 1],
      [1, 0, 1, 1, 1, 1, 0, 0, 1],
      [1, 0, 1, 1, 1, 1, 1, 0, 1],
      [1, 0, 1, 1, 1, 1, 1, 0, 1],
      [1, 0, 1, 1, 1, 1, 0, 0, 1],
      [1, 0, 0, 0, 2, 0, 0, 1, 1],
      [1, 1, 1, 1, 1, 1, 1, 1, 1]
    ]
  },
  {
    "start_position": [7, 7],
    "layout": [
      [1, 1, 1, 1, 1, 1, 1, 1, 1],
      [1, 2, 0, 0, 1, 1, 1, 0, 1],
      [1, 0, 1, 0, 1, 1, 0, 1, 1],
      [1, 0, 0, 0, 0, 0, 1, 1, 1],
      [1, 1, 1, 0, 1, 0, 1, 1, 1],
      [1, 1, 1, 0, 0, 0, 0, 0, 1],
      [1, 1, 0, 1, 1, 0, 1, 0, 1],
      [1, 0, 1, 1, 1, 0, 0, 0, 1],
      [1, 1, 1, 1, 1, 1, 1, 1, 1]
    ]
  },
  {
    "start_position": [4, 3],
    "layout": [
      [1, 1, 1, 1, 1, 1, 1, 1, 1],
      [1, 1, 0, 0, 2, 1, 0, 1, 1],
      [1, 1, 0, 1, 1, 1, 0, 1, 1],
      [1, 1, 0, 1, 0, 1, 0, 1, 1],
      [1, 1, 0, 1, 0, 0, 0, 1, 1],
      [1, 1, 0, 1, 0, 1, 1, 1, 1],
      [1, 1, 0, 1, 0, 1, 1, 1, 1],
      [1, 1, 0, 0, 0, 1, 1, 1, 1],
      [1, 1, 1, 1, 1, 1, 1, 1, 1]
    ]
  },
  {
    "start_position": [1, 1],
    "layout": [
      [1, 1, 1, 1, 1, 1, 1, 1, 1],
      [1, 0, 0, 0, 0, 0, 0, 0, 1],
      [1, 0, 1, 0, 1, 0, 1, 0, 1],
      [1, 0, 1, 0, 1, 0, 1, 0, 1],
      [1, 0, 1, 0, 1, 0, 1, 0, 1],
      [1, 1, 1, 0, 1, 0, 1, 0, 1],
      [1, 1, 1, 1, 1, 0, 1, 0, 1],
      [1, 1, 1, 1, 1, 1, 1, 2, 1],
      [1, 1, 1, 1, 1, 1, 1, 1, 1]
    ]
  },
  {
    "start_position": [1, 1],
    "layout": [
      [1, 1, 1, 1, 1, 1, 1, 1, 1],
      [1, 0, 1, 1, 1, 1, 1, 1, 1],
      [1, 0, 0, 0, 0, 0, 0, 1, 1],
      [1, 1, 1, 0, 1, 1, 1, 1, 1],
      [1, 1, 1, 0, 0, 1, 1, 1, 1],
      [1, 0, 0, 0, 1, 1, 1, 1, 1],
      [1, 0, 1, 0, 1, 0, 1, 1, 1],
      [1, 0, 1, 0, 0, 0, 0, 2, 1],
      [1, 1, 1, 1, 1, 1, 1, 1, 1]
    ]
  },
  {
    "start_position": [1, 4],
    "layout": [
      [1, 1, 1, 1, 1, 1, 1, 1, 1],
      [1, 1, 0, 1, 1, 1, 1, 1, 1],
      [1, 1, 0, 0, 0, 0, 0, 1, 1],
      [1, 1, 0, 1, 1, 1, 0, 1, 1],
      [1, 0, 0, 1, 0, 1, 0, 1, 1],
      [1, 1, 0, 1, 0, 1, 0, 1, 1],
      [1, 1, 0, 0, 0, 1, 0, 1, 1],
      [1, 1, 0, 1, 1, 1, 2, 1, 1],
      [1, 1, 1, 1, 1, 1, 1, 1, 1]
    ]
  },
  {
    "start_position": [1, 1],
    "layout": [
      [1, 1, 1, 1, 1, 1, 1, 1, 1],
      [1, 0, 0, 1, 0, 0, 0, 0, 1],
      [1, 1, 0, 1, 1, 0, 1, 0, 1],
      [1, 1, 0, 0, 1, 0, 1, 0, 1],
      [1, 1, 1, 0, 1, 0, 1, 0, 1],
      [1, 0, 0, 0, 1, 0, 1, 2, 1],
      [1, 1, 1, 0, 0, 0, 1, 1, 1],
      [1, 1, 1, 0, 1, 1, 1, 1, 1],
      [1, 1, 1, 1, 1, 1, 1, 1, 1]
    ]
  },
  {
    "start_position": [1, 7],
    "layout": [
      [1, 1, 1, 1, 1, 1, 1, 1, 1],
      [1, 0, 0, 0, 0, 0, 1, 1, 1],
      [1, 0, 1, 1, 1, 0, 1, 1, 1],
      [1, 0, 1, 0, 0, 0, 1, 1, 1],
      [1, 0, 1, 0, 1, 0, 1, 1, 1],
      [1, 0, 1, 2, 1, 0, 0, 1, 1],
      [1, 0, 1, 1, 1, 1, 0, 1, 1],
      [1, 0, 1, 0, 0, 0, 0, 1, 1],
      [1, 1, 1, 1, 1, 1, 1, 1, 1]
    ]
  },
  {
    "start_position": [1, 1],
    "layout": [
      [1, 1, 1, 1, 1, 1, 1, 1, 1],
      [1, 0, 0, 0, 0, 0, 0, 0, 1],
      [1, 1, 1, 1, 1, 1, 1, 0, 1],
      [1, 0, 0, 0, 0, 0, 1, 0, 1],
      [1, 0, 1, 1, 1, 0, 1, 0, 1],
      [1, 0, 1, 2, 0, 0, 1, 0, 1],
      [1, 0, 1, 1, 1, 1, 1, 0, 1],
      [1, 0, 0, 0, 0, 0, 0, 0, 1],
      [1, 1, 1, 1, 1, 1, 1, 1, 1]
    ]
  }
]
